.............
.1+++...+++2.
.+++++++++++.
.++s+++++s++.
.++++O+O++++.
..++O+++O++..
..+++++++++..
..++O+++O++..
.++++O+O++++.
.++s+++++s++.
.+++++++++++.
.4+++...+++3.
.............
