...........
....+1.....
...O+++....
...O+++OO..
..+++s++++.
.4++s+s++2.
.++++s+++..
..OO+++O...
....+++O...
.....3+....
...........
