....O....
.1+++++2.
.+++++++.
.+++++++.
O+++++++O
.+++++++.
.+++++++.
.4+++++3.
....O....
