....OO....
.1++gg++2.
.+++gg+++.
.+++gg+++.
OgggOOgggO
OgggOOgggO
.+++gg+++.
.+++gg+++.
.4++gg++3.
....OO....
