.....O.....
.1+++++++2.
.+++++++++.
.++O+O+O++.
.+++++++++.
O++O+O+O++O
.+++++++++.
.++O+O+O++.
.+++++++++.
.4+++++++3.
.....O.....
