....OO....
.1++ss++2.
.+++ss+++.
.+++ss+++.
OsssOOsssO
OsssOOsssO
.+++ss+++.
.+++ss+++.
.4++ss++3.
....OO....
