....OO....
.1++++++2.
.++++++++.
.++O+OO++.
O++O+++++O
O+++++O++O
.++OO+O++.
.++++++++.
.4++++++3.
....OO....
